++++++++++++++++++++++
+ + ++ ++ +            
+         +           
+         +            
++++++++++            
+ + ++ ++++ +++ ++    
+ + + + ++ +++ +      
+                     
++ ++ + +             
+++++ + + ++ + +      
+++++ +++ + + ++ +    
+                     
+ +  + + +  S          
+++++ + + + + + +     
++++++++++++++++++++++
